111111111111111111111111111
101100001111000100111001001
1000011000C0000001000000001
110011110110011100011011001
100111100110000111000110011
110011110110011100011011011
100111100110000111000110011
100100001111000000000C01001
11C011110110001011011001011
10P000100111C011011011E1001
111011110010011100011111011
111111111111111111111111111