1111111111111111111111111111
1010C0C0C0C0C0C0C0C0C0C0C0C1
1011010101011111111111111111
111111EPC1010101111111111111
1111111111111111111111111111